XXXXXXXXXXXXXXXXXX
X                X
X           XX   X
XXXXXX      XX   X
X                X
X                X
X                X
X    P      XXXXXX
X                X
X                X
X                X
XXXXXX     XX    X
X          XX    X
X             TQ X             
XXXXXXXXXXXXXXXXXX