XXXXXXXXXXXXXXXXXXXX
X                  X
X                  X
X   XX        XX   X
X   XX  P     XX   X
X                  X
X                  X
XXXXXX        XXXXXX
X                  X
X               TQ X
X   XX        XX   X
X   XX        XX   X
X                  X
X                  X
XXXXXXXXXXXXXXXXXXXX