XXXXXXXXXXXXXXXXXXXX
X                  X
X   P           TQ X
X      XXXXXX      X
X                  X
X      XXXXXX      X
X                  X
X  XX          XX  X
X                  X
X      XXXXXX      X
X                  X
X      XXXXXX      X
X                  X
X                  X
XXXXXXXXXXXXXXXXXXXX