XXXXXXXXXXXXXXXXXXXX
X                  X
X                  X    
X  X X     XXXXXX  X
X  X X          X  X 
X  X X    XXXXX X  X
X  X X    P   X X  X
X  X X   X    X X  X
X  X X        X X  X
X  X XXXX     X X  X 
X  X               X
X  XXXXXX          X  
X             TQ   X
X                  X
XXXXXXXXXXXXXXXXXXXX
