XXXXXXXXXXXXXXXXXXX
X                 X
X                 X
X         XX      X
XXXXXX            X                 X
X                 X
X                 X
X    P       XXXXXX
X                 X
X                 X
XXXXXX            X
X         XX      X
X                 X
X            TQ   X                
XXXXXXXXXXXXXXXXXXX
